# added postag entries
#-------------------------------------------------------------------------------
# Do not add words here, but report them to languagetool@taaltik.nl
#-------------------------------------------------------------------------------
borger	borger	ZNW:EKV:DE_
gemeenteregistratie	gemeenteregistratie	ZNW:EKV:DE_
houderij	houderij	ZNW:EKV:DE_
luxatie	luxatie	ZNW:EKV:DE_
opwekker	opwekker	ZNW:EKV:DE_
podoloog	podoloog	ZNW:EKV:DE_
relativist	relativist	ZNW:EKV:DE_
schetser	schetser	ZNW:EKV:DE_
screening	screening	ZNW:EKV:DE_
slurper	slurper	ZNW:EKV:DE_
straler	straler	ZNW:EKV:DE_
testklinieken	testkliniek	ZNW:MRV:DE_
vleugelruiter	vleugelruiter	ZNW:EKV:DE_
vleugelruiters	vleugelruiter	ZNW:MRV:DE_
vleugelvinger	vleugelvinger	ZNW:EKV:DE_
vleugelvingers	vleugelvinger	ZNW:MRV:DE_
corticosteroïde	corticosteroïde	ZNW:EKV:DE_
klimoprank	klimoprank	ZNW:EKV:DE_
zeildeel	zeildeel	ZNW:EKV:HET
paleisbeheerder	paleisbeheerder	ZNW:EKV:DE_
vpn	vpn	ZNW:EKV
schermvullend	schermvullend	BNW:STL:ONV
quantumcomputer	quantumcomputer	ZNW:EKV:DE_
coronacertificaten	coronacertificaat	ZNW:MRV:DE_
PO-Raad	PO-Raad	ZNW:EKV:DE_
Dalmaus	Dalmau	ENM:BEZ
Daytona	Daytona	ENM:LOC:PTS
Avrox	Avrox	ENM:ORG
Viracocha	Viracocha	ENM:OTH
Takeshi	Takeshi	ENM:PER:FST
Ajax-doelman	Ajax-doelman	ZNW:EKV:DE_
Mercedes-motor	Mercedes-motor	ZNW:EKV:DE_
Mercedes-motoren	Mercedes-motor	ZNW:MRV:DE_
safetycar	safetycar	ZNW:EKV:DE_
safetycars	safetycar	ZNW:MRV:DE_
mediumband	mediumband	ZNW:EKV:DE_
mediumbanden	mediumband	ZNW:MRV:DE_
safetycarsituatie	safetycarsituatie	ZNW:EKV:DE_
safetycarsituaties	safetycarsituatie	ZNW:MRV:DE_
niet-ontvankelijkverklaring	niet-ontvankelijkverklaring	ZNW:EKV:DE_
Vandervelde	Vandervelde	ENM:PER:LST
Sint-Pietersbasiliek	Sint-Pietersbasiliek	ZNW:EKV:DE_
Vandeputte	Vandeputte	ENM:PER:LST
Oudtshoorn	Oudtshoorn	ENM:LOC:PTS
kokermot	kokermot	ZNW:EKV:DE_
kokermotten	kokermot	ZNW:MRV:DE_
Schielands	Schieland	ENM:BEZ
Schielands	Schielands	BNW:STL:ONV
Schielandse	Schielands	BNW:STL:VRB
Rottemeren	Rottemeren	ZNW:MRV:DE_
Flintstones	Flintstones	ZNW:MRV:DE_
Sint-Pietersabdij	Sint-Pietersabdij	ZNW:EKV:DE_
strafrechterlijk	strafrechterlijk	BNW:STL:ONV
strafrechterlijke	strafrechterlijk	BNW:STL:VRB
Vanderlande	Vanderlande	ENM:ORG
Wittevrouwen	Wittevrouwen	ENM:LOC:RGN
niet-ontvankelijkverklaringen	niet-ontvankelijkverklaring	ZNW:MRV:DE_
Harnaschpolder	Harnaschpolder	ZNW:EKV:DE_
Scharnhorst	Scharnhorst	ENM:OTH
Runnersworld	Runnersworld	ENM:ORG
Binnenrotte	Binnenrotte	ZNW:EKV:DE_
Beterboeken	Beterboeken	ENM:ORG
vrouwenboksen	vrouwenboksen	ZNW:EKV:HET
kankerplakboek	kankerplakboek	ZNW:EKV:HET
juchtleerkever	juchtleerkever	ZNW:EKV:DE_
hippiecommune	hippiecommune	ZNW:EKV:DE_
hippiecommunes	hippiecommune	ZNW:MRV:DE_
bestelfraude	bestelfraude	ZNW:EKV:DE_
gifjesplatform	gifjesplatform	ZNW:EKV:HET
evenementenmatrix	evenementenmatrix	ZNW:EKV:DE_
Nigerdelta	Nigerdelta	ZNW:EKV:DE_
Plantagenet	Plantagenet	ENM:PER:LST
Uilenstede	Uilenstede	ENM:LOC:RGN
bloeddrukverlager	bloeddrukverlager	ZNW:EKV:DE_
bloeddrukverlagers	bloeddrukverlager	ZNW:MRV:DE_
knooppuntachtig	knooppuntachtig	BNW:STL:ONV
knooppuntachtige	knooppuntachtig	BNW:STL:VRB
Dappermarkt	Dappermarkt	ZNW:EKV:DE_
hangmatspin	hangmatspin	ZNW:EKV:DE_
hangmatspinnen	hangmatspin	ZNW:MRV:DE_
hangmatspinnetje	hangmatspin	ZNW:EKV:VRK:HET
hangmatspinnetjes	hangmatspin	ZNW:MRV:VRK:DE_
Naamsestraat	Naamsestraat	ZNW:EKV:DE_
Willemsparkweg	Willemsparkweg	ZNW:EKV:DE_
Vistaprint	Vistaprint	ENM:ORG
cardanaandrijving	cardanaandrijving	ZNW:EKV:DE_
cardanaandrijvingen	cardanaandrijving	ZNW:MRV:DE_
Hobbemastraat	Hobbemastraat	ZNW:EKV:DE_
Bakersfield	Bakersfield	ENM:LOC:PTS
Betelgeuze	Betelgeuze	ENM:OTH
Pelikaanstraat	Pelikaanstraat	ZNW:EKV:DE_
Tjongerschans	Tjongerschans	ENM:LOC:PTS
Hezelstraat	Hezelstraat	ZNW:EKV:DE_
Leidsegracht	Leidsegracht	ZNW:EKV:DE_
superenthousiast	superenthousiast	BNW:STL:ONV
superenthousiaste	superenthousiast	BNW:STL:VRB
breedplaatvloer	breedplaatvloer	ZNW:EKV:DE_
breedplaatvloeren	breedplaatvloer	ZNW:MRV:DE_
Smithfield	Smithfield	ENM:LOC:PTS
Wijkertunnel	Wijkertunnel	ZNW:EKV:DE_
Starrevaart	Starrevaart	ZNW:EKV:DE_
Paramount	Paramount	ENM:ORG
Janskerk	Janskerk	ZNW:EKV:DE_
Homeland	Homeland	ENM:PRD
Streetview	Streetview	ENM:PRD
Sint-Pieterskerk	Sint-Pieterskerk	ZNW:EKV:DE_
Longfonds	Longfonds	ZNW:EKV:HET
Bornholm	Bornholm	ENM:LOC:PTS
Nassaulaan	Nassaulaan	ZNW:EKV:DE_
Waalkade	Waalkade	ZNW:EKV:DE_
Winschoterdiep	Winschoterdiep	ZNW:EKV:HET
Walstraat	Walstraat	ZNW:EKV:DE_
Zeelandbrug	Zeelandbrug	ZNW:EKV:DE_
Eemskanaal	Eemskanaal	ZNW:EKV:HET
Lijnbaansgracht	Lijnbaansgracht	ZNW:EKV:DE_
Hooigracht	Hooigracht	ZNW:EKV:DE_
inhalatiecorticosteroïde	inhalatiecorticosteroïde	ZNW:EKV:DE_
inhalatiecorticosteroïden	inhalatiecorticosteroïde	ZNW:MRV:DE_
achterwielaangedreven	achterwielaangedreven	BNW:STL:ONV
achterwielaangedreven	achterwielaangedreven	BNW:STL:VRB
achterwielaangedreven	achterwielaangedreven	ZNW:EKV:DE_
bovenooglidcorrectie	bovenooglidcorrectie	ZNW:EKV:DE_
bovenooglidcorrecties	bovenooglidcorrectie	ZNW:MRV:DE_
stroomgebiedbeheerplan	stroomgebiedbeheerplan	ZNW:EKV:HET
stroomgebiedbeheerplannen	stroomgebiedbeheerplan	ZNW:MRV:DE_
temperatuurswisseling	temperatuurswisseling	ZNW:EKV:DE_
temperatuurswisselingen	temperatuurswisseling	ZNW:MRV:DE_
veterinairrechtelijk	veterinairrechtelijk	BNW:STL:ONV
veterinairrechtelijke	veterinairrechtelijk	BNW:STL:VRB
parkinsonpatiënt	parkinsonpatiënt	ZNW:EKV:DE_
parkinsonpatiënten	parkinsonpatiënt	ZNW:MRV:DE_
blockchaintechnologie	blockchaintechnologie	ZNW:EKV:DE_
blockchaintechnologieën	blockchaintechnologie	ZNW:MRV:DE_
elektronenmicroscopie	elektronenmicroscopie	ZNW:EKV:DE_
bloedglucoseverlagend	bloedglucoseverlagend	BNW:STL:ONV
bloedglucoseverlagende	bloedglucoseverlagend	BNW:STL:ONV
ruitensproeiervloeistof	ruitensproeiervloeistof	ZNW:EKV:DE_
ruitensproeiervloeistoffen	ruitensproeiervloeistof	ZNW:MRV:DE_
wetenschapsfilosofisch	wetenschapsfilosofisch	BNW:STL:ONV
wetenschapsfilosofische	wetenschapsfilosofisch	BNW:STL:VRB
rekenkameronderzoek	rekenkameronderzoek	ZNW:EKV:HET
rekenkameronderzoeken	rekenkameronderzoek	ZNW:MRV:DE_
ontheffingverlening	ontheffingverlening	ZNW:EKV:DE_
ontheffingverleningen	ontheffingverlening	ZNW:MRV:DE_
fokwaardeschatting	fokwaardeschatting	ZNW:EKV:DE_
fokwaardeschattingen	fokwaardeschatting	ZNW:MRV:DE_
spreadsheetprogramma	spreadsheetprogramma	ZNW:EKV:HET
spreadsheetprogramma's	spreadsheetprogramma	ZNW:MRV:DE_
buitensporigtekortprocedure	buitensporigtekortprocedure	ZNW:EKV:DE_
buitensporigtekortprocedures	buitensporigtekortprocedure	ZNW:MRV:DE_
aardappelverwerkende	aardappelverwerkend	BNW:STL:VRB
hoofdhuurovereenkomst	hoofdhuurovereenkomst	ZNW:EKV:DE_
elektronischecommunicatienetwerk	elektronischecommunicatienetwerk	ZNW:EKV:HET
elektronischecommunicatienetwerken	elektronischecommunicatienetwerk	ZNW:MRV:DE_
mediationovereenkomst	mediationovereenkomst	ZNW:EKV:DE_
mediationovereenkomsten	mediationovereenkomst	ZNW:MRV:DE_
glycogeenvoorraad	glycogeenvoorraad	ZNW:EKV:DE_
glycogeenvoorraden	glycogeenvoorraad	ZNW:MRV:DE_
glasvezelversterkt	glasvezelversterkt	BNW:STL:ONV
glasvezelversterkte	glasvezelversterkt	BNW:STL:VRB
inkomstenvrijlating	inkomstenvrijlating	ZNW:EKV:DE_
vogelvrijverklaarde	vogelvrijverklaarde	ZNW:EKV:DE_
vogelvrijverklaarden	vogelvrijverklaarde	ZNW:MRV:DE_
bio-ingenieurswetenschap	bio-ingenieurswetenschap	ZNW:EKV:DE_
bio-ingenieurswetenschappen	bio-ingenieurswetenschap	ZNW:MRV:DE_
hemodialysepatiënt	hemodialysepatiënt	ZNW:EKV:DE_
hemodialysepatiënten	hemodialysepatiënt	ZNW:MRV:DE_
coeliakiepatiënt	coeliakiepatiënt	ZNW:EKV:DE_
coeliakiepatiënten	coeliakiepatiënt	ZNW:MRV:DE_
urinezuurkristal	urinezuurkristal	ZNW:EKV:HET
urinezuurkristallen	urinezuurkristal	ZNW:MRV:DE_
annulatieverzekering	annulatieverzekering	ZNW:EKV:DE_
annulatieverzekeringen	annulatieverzekering	ZNW:MRV:DE_
financiëledienstverlener	financiëledienstverlener	ZNW:EKV:DE_
financiëledienstverleners	financiëledienstverlener	ZNW:MRV:DE_
groothoekobjectief	groothoekobjectief	ZNW:EKV:HET
groothoekobjectieven	groothoekobjectief	ZNW:MRV:DE_
gemeenteraadverkiezing	gemeenteraadverkiezing	ZNW:EKV:DE_
gemeenteraadverkiezingen	gemeenteraadverkiezing	ZNW:MRV:DE_
endometriumcarcinoom	endometriumcarcinoom	ZNW:EKV:HET
endometriumcarcinomen	endometriumcarcinoom	ZNW:MRV:DE_
begrotingsgefinancierd	begrotingsgefinancierd	BNW:STL:ONV
begrotingsgefinancierde	begrotingsgefinancierd	BNW:STL:VRB
semi-autobiografisch	semi-autobiografisch	BNW:STL:ONV
semi-autobiografische	semi-autobiografisch	BNW:STL:VRB
uitlaatgasrecirculatie	uitlaatgasrecirculatie	ZNW:EKV:DE_
informatiegestuurd	informatiegestuurd	BNW:STL:ONV
informatiegestuurde	informatiegestuurd	BNW:STL:VRB
remuneratiecommissie	remuneratiecommissie	ZNW:EKV:DE_
remuneratiecommissies	remuneratiecommissie	ZNW:MRV:DE_
criteriumvaliditeit	criteriumvaliditeit	ZNW:EKV:DE_
literatuurgeschiedschrijving	literatuurgeschiedschrijving	ZNW:EKV:DE_
handhavingstrategie	handhavingstrategie	ZNW:EKV:DE_
handhavingstrategieën	handhavingstrategie	ZNW:MRV:DE_
temperatuursschommelingen	temperatuursschommelingen	ZNW:EKV:DE_
temperatuursschommeling	temperatuursschommeling	ZNW:EKV:DE_
temperatuursschommelingen	temperatuursschommeling	ZNW:MRV:DE_
meerlaagsveiligheid	meerlaagsveiligheid	ZNW:EKV:DE_
vleeskuikenouderdier	vleeskuikenouderdier	ZNW:EKV:HET
vleeskuikenouderdieren	vleeskuikenouderdier	ZNW:MRV:DE_
hartritmevariabiliteit	hartritmevariabiliteit	ZNW:EKV:DE_
clementieverzoeker	clementieverzoeker	ZNW:EKV:DE_
clementieverzoekers	clementieverzoeker	ZNW:MRV:DE_
gasfabrieksterrein	gasfabrieksterrein	ZNW:EKV:HET
gasfabrieksterreinen	gasfabrieksterrein	ZNW:MRV:DE_
warmtekrachtinstallatie	warmtekrachtinstallatie	ZNW:EKV:DE_
warmtekrachtinstallaties	warmtekrachtinstallatie	ZNW:MRV:DE_
materieellogistiek	materieellogistiek	BNW:STL:ONV
materieellogistieke	materieellogistiek	BNW:STL:VRB
groeihormoondeficiëntie	groeihormoondeficiëntie	ZNW:EKV:DE_
belastinglatentie	belastinglatentie	ZNW:EKV:DE_
belastinglatenties	belastinglatentie	ZNW:MRV:DE_
aspiratiepneumonie	aspiratiepneumonie	ZNW:EKV:DE_
aspiratiepneumonieën	aspiratiepneumonie	ZNW:MRV:DE_
stroomlijnmaterieel	stroomlijnmaterieel	ZNW:EKV:HET
steunpuntingenieur	steunpuntingenieur	ZNW:EKV:DE_
koolhydraatbeperking	koolhydraatbeperking	ZNW:EKV:DE_
koolhydraatbeperkingen	koolhydraatbeperking	ZNW:MRV:DE_
burgerschapscompetentie	burgerschapscompetentie	ZNW:EKV:DE_
burgerschapscompetenties	burgerschapscompetentie	ZNW:MRV:DE_
bedrijfsleveninstrumentarium	bedrijfsleveninstrumentarium	ZNW:EKV:HET
medebeslissingsbevoegdheid	medebeslissingsbevoegdheid	ZNW:EKV:DE_
medebeslissingsbevoegdheden	medebeslissingsbevoegdheid	ZNW:MRV:DE_
cultivatiebeoefening	cultivatiebeoefening	ZNW:EKV:DE_
waterstofafleverinstallatie	waterstofafleverinstallatie	ZNW:EKV:DE_
waterstofafleverinstallaties	waterstofafleverinstallatie	ZNW:MRV:DE_
mediationvaardigheid	mediationvaardigheid	ZNW:EKV:DE_
mediationvaardigheden	mediationvaardigheid	ZNW:MRV:DE_
levenslanggestrafte	levenslanggestrafte	ZNW:EKV:DE_
levenslanggestraften	levenslanggestrafte	ZNW:MRV:DE_
schadelastbeheersing	schadelastbeheersing	ZNW:EKV:DE_
onderwijsleergesprek	onderwijsleergesprek	ZNW:EKV:HET
onderwijsleergesprekken	onderwijsleergesprek	ZNW:MRV:DE_
bestuurderszitplaats	bestuurderszitplaats	ZNW:EKV:DE_
bestuurderszitplaatsen	bestuurderszitplaats	ZNW:MRV:DE_
belastingsvermindering	belastingsvermindering	ZNW:EKV:DE_
belastingsverminderingen	belastingsvermindering	ZNW:MRV:DE_
belastingsinkomsten	belastingsinkomsten	ZNW:MRV:DE_
wereldtuinbouwtentoonstelling	wereldtuinbouwtentoonstelling	ZNW:EKV:DE_
stuurstandrijtuig	stuurstandrijtuig	ZNW:EKV:HET
stuurstandrijtuigen	stuurstandrijtuig	ZNW:MRV:DE_
bloedsuikerverlagend	bloedsuikerverlagend	BNW:STL:ONV
bloedsuikerverlagende	bloedsuikerverlagend	BNW:STL:VRB
onderooglidcorrectie	onderooglidcorrectie	ZNW:EKV:DE_
onderooglidcorrecties	onderooglidcorrectie	ZNW:MRV:DE_
containerbinnenvaart	containerbinnenvaart	ZNW:EKV:DE_
onroerendzaakbelasting	onroerendzaakbelasting	ZNW:EKV:DE_
onroerendzaakbelastingen	onroerendzaakbelasting	ZNW:MRV:DE_
werkgeverstussenkomst	werkgeverstussenkomst	ZNW:EKV:DE_
werkgeverstussenkomsten	werkgeverstussenkomst	ZNW:MRV:DE_
moeder-dochterrichtlijn	moeder-dochterrichtlijn	ZNW:EKV:DE_
verslavingszorginstelling	verslavingszorginstelling	ZNW:EKV:DE_
verslavingszorginstellingen	verslavingszorginstelling	ZNW:MRV:DE_
fibromyalgiepatiënt	fibromyalgiepatiënt	ZNW:EKV:DE_
fibromyalgiepatiënten	fibromyalgiepatiënt	ZNW:MRV:DE_
auto-immuunaandoening	auto-immuunaandoening	ZNW:EKV:DE_
auto-immuunaandoeningen	auto-immuunaandoening	ZNW:MRV:DE_
kraamzorgorganisatie	kraamzorgorganisatie	ZNW:EKV:DE_
kraamzorgorganisaties	kraamzorgorganisatie	ZNW:MRV:DE_
koolhydraatstofwisseling	koolhydraatstofwisseling	ZNW:EKV:DE_
screeningsmammografie	screeningsmammografie	ZNW:EKV:DE_
screeningsmammografieën	screeningsmammografie	ZNW:MRV:DE_
landsgrensoverschrijdend	landsgrensoverschrijdend	BNW:STL:ONV
landsgrensoverschrijdende	landsgrensoverschrijdend	BNW:STL:VRB
knooppuntontwikkeling	knooppuntontwikkeling	ZNW:EKV:DE_
knooppuntontwikkelingen	knooppuntontwikkeling	ZNW:MRV:DE_
financiëlezekerheidsovereenkomst	financiëlezekerheidsovereenkomst	ZNW:EKV:DE_
financiëlezekerheidsovereenkomsten	financiëlezekerheidsovereenkomst	ZNW:MRV:DE_
zwangerschapshypertensie	zwangerschapshypertensie	ZNW:EKV:DE_
belastingsverhoging	belastingsverhoging	ZNW:EKV:DE_
belastingsverhogingen	belastingsverhoging	ZNW:MRV:DE_
nationaalrechtelijk	nationaalrechtelijk	BNW:STL:ONV
nationaalrechtelijke	nationaalrechtelijk	BNW:STL:VRB
kampioenschapsclubmatch	kampioenschapsclubmatch	ZNW:EKV:DE_
kampioenschapsclubmatches	kampioenschapsclubmatch	ZNW:MRV:DE_
continuümhypothese	continuümhypothese	ZNW:EKV:DE_
vrijdenkersvereniging	vrijdenkersvereniging	ZNW:EKV:DE_
vrijdenkersverenigingen	vrijdenkersvereniging	ZNW:MRV:DE_
langstudeerdersmaatregel	langstudeerdersmaatregel	ZNW:EKV:DE_
langstudeerdersmaatregelen	langstudeerdersmaatregel	ZNW:MRV:DE_
okselklierdissectie	okselklierdissectie	ZNW:EKV:DE_
okselklierdissecties	okselklierdissectie	ZNW:MRV:DE_
medebewindsbevoegdheid	medebewindsbevoegdheid	ZNW:EKV:DE_
medebewindsbevoegdheden	medebewindsbevoegdheid	ZNW:MRV:DE_
middellangeafstandsloper	middellangeafstandsloper	ZNW:EKV:DE_
middellangeafstandslopers	middellangeafstandsloper	ZNW:MRV:DE_
lithium-ionbatterij	lithium-ionbatterij	ZNW:EKV:DE_
lithium-ionbatterijen	lithium-ionbatterij	ZNW:MRV:DE_
lithiumionbatterij	lithiumionbatterij	ZNW:EKV:DE_
lithiumionbatterijen	lithiumionbatterij	ZNW:MRV:DE_
exequaturprocedure	exequaturprocedure	ZNW:EKV:DE_
exequaturprocedures	exequaturprocedure	ZNW:MRV:DE_
handelshuurovereenkomst	handelshuurovereenkomst	ZNW:EKV:DE_
handelshuurovereenkomsten	handelshuurovereenkomst	ZNW:MRV:DE_
vloeistofgekoeld	vloeistofgekoeld	BNW:STL:ONV
vloeistofgekoelde	vloeistofgekoeld	BNW:STL:VRB
koningschieten	koningschieten	ZNW:EKV:HET
slakrupsvlinder	slakrupsvlinder	ZNW:EKV:DE_
slakrupsvlinders	slakrupsvlinder	ZNW:MRV:DE_
heldervoelend	heldervoelend	BNW:STL:ONV
heldervoelende	heldervoelend	BNW:STL:VRB
steenworpafstand	steenworpafstand	ZNW:EKV:DE_
steenworpafstanden	steenworpafstand	ZNW:MRV:DE_
buitenwerelds	buitenwerelds	BNW:STL:ONV
buitenwereldse	buitenwerelds	BNW:STL:VRB
mindfulnesstraining	mindfulnesstraining	ZNW:EKV:DE_
mindfulnesstrainingen	mindfulnesstraining	ZNW:MRV:DE_
tussenhoudster	tussenhoudster	ZNW:EKV:DE_
tussenhoudsters	tussenhoudster	ZNW:MRV:DE_
huisstofmijtallergie	huisstofmijtallergie	ZNW:EKV:DE_
huisstofmijtallergieën	huisstofmijtallergie	ZNW:MRV:DE_
opdrachtprompt	opdrachtprompt	ZNW:EKV:DE_
opdrachtprompts	opdrachtprompt	ZNW:MRV:DE_
sikkelmot	sikkelmot	ZNW:EKV:DE_
sikkelmotten	sikkelmot	ZNW:MRV:DE_
gezelschapsaquarium	gezelschapsaquarium	ZNW:EKV:HET
gezelschapsaquaria	gezelschapsaquarium	ZNW:MRV:DE_
gezelschapsaquariums	gezelschapsaquarium	ZNW:MRV:DE_
geluidsreducerend	geluidsreducerend	BNW:STL:ONV
geluidsreducerende	geluidsreducerend	BNW:STL:VRB
vignettering	vignettering	ZNW:EKV:DE_
vignetteringen	vignettering	ZNW:MRV:DE_
natriumhypochloriet	natriumhypochloriet	ZNW:EKV
onschuldpresumptie	onschuldpresumptie	ZNW:EKV:DE_
boekbandontwerper	boekbandontwerper	ZNW:EKV:DE_
boekbandontwerpers	boekbandontwerper	ZNW:MRV:DE_
inlenersaansprakelijkheid	inlenersaansprakelijkheid	ZNW:EKV:DE_
voedselzandloper	voedselzandloper	ZNW:EKV:DE_
voedselzandlopers	voedselzandloper	ZNW:MRV:DE_
antibioticumgebruik	antibioticumgebruik	ZNW:EKV:HET
sheriffkantoor	sheriffkantoor	ZNW:EKV:HET
sheriffkantoren	sheriffkantoor	ZNW:MRV:DE_
aanzegverplichting	aanzegverplichting	ZNW:EKV:DE_
schaakbordpatroon	schaakbordpatroon	ZNW:EKV:HET
schaakbordpatronen	schaakbordpatroon	ZNW:MRV:DE_
schaduwbankieren	schaduwbankieren	WKW:INF:ZNW:HET
recruitmentproces	recruitmentproces	ZNW:EKV:HET
recruitmentprocessen	recruitmentproces	ZNW:MRV:DE_
gezichtstrek	gezichtstrek	ZNW:EKV:DE_
gezichtstrekjes	gezichtstrek	ZNW:MRV:VRK:DE_
gezichtstrekken	gezichtstrek	ZNW:MRV:DE_
portiervergrendeling	portiervergrendeling	ZNW:EKV:DE_
portiervergrendelingen	portiervergrendeling	ZNW:MRV:DE_
aanreisinformatie	aanreisinformatie	ZNW:EKV:DE_
cafeïnehoudend	cafeïnehoudend	BNW:STL:ONV
cafeïnehoudende	cafeïnehoudend	BNW:STL:VRB
registerpodoloog	registerpodoloog	ZNW:EKV:DE_
registerpodologen	registerpodoloog	ZNW:MRV:DE_
dienstrevolver	dienstrevolver	ZNW:EKV:DE_
dienstrevolvers	dienstrevolver	ZNW:MRV:DE_
roamingtarief	roamingtarief	ZNW:EKV:HET
roamingtarieven	roamingtarief	ZNW:MRV:DE_
arbeidshygiënisch	arbeidshygiënisch	BNW:STL:ONV
arbeidshygiënische	arbeidshygiënisch	BNW:STL:VRB
handvatverwarming	handvatverwarming	ZNW:EKV:DE_
heidenvolk	heidenvolk	ZNW:EKV:HET
heidenvolken	heidenvolk	ZNW:MRV:DE_
heidenvolkeren	heidenvolk	ZNW:MRV:DE_
essentaksterfte	essentaksterfte	ZNW:EKV:DE_
brandofferaltaar	brandofferaltaar	ZNW:EKV:HET
zilverharig	zilverharig	BNW:STL:ONV
zilverharige	zilverharig	BNW:STL:VRB
dwingendrechtelijk	dwingendrechtelijk	BNW:STL:ONV
dwingendrechtelijke	dwingendrechtelijk	BNW:STL:VRB
anti-personeelmijn	anti-personeelmijn	ZNW:EKV:DE_
anti-personeelmijnen	anti-personeelmijn	ZNW:MRV:DE_
antipersoneelmijn	antipersoneelmijn	ZNW:EKV:DE_
antipersoneelmijnen	antipersoneelmijn	ZNW:MRV:DE_
naturaverzekering	naturaverzekering	ZNW:EKV:DE_
naturaverzekeringen	naturaverzekering	ZNW:MRV:DE_
dipoolmoment	dipoolmoment	ZNW:EKV:HET
dipoolmomenten	dipoolmoment	ZNW:MRV:DE_
niercelcarcinoom	niercelcarcinoom	ZNW:EKV:HET
niercelcarcinomen	niercelcarcinoom	ZNW:MRV:DE_
waterstofcyanide	waterstofcyanide	ZNW:EKV:HET
glutensensitiviteit	glutensensitiviteit	ZNW:EKV:DE_
stinzenplant	stinzenplant	ZNW:EKV:DE_
stinzenplanten	stinzenplant	ZNW:MRV:DE_
stinzenplantje	stinzenplant	ZNW:EKV:VRK:HET
stinzenplantjes	stinzenplant	ZNW:MRV:VRK:DE_
achtererfgebied	achtererfgebied	ZNW:EKV:HET
achtererfgebieden	achtererfgebied	ZNW:MRV:DE_
mediationtraject	mediationtraject	ZNW:EKV:HET
mediationtrajecten	mediationtraject	ZNW:MRV:DE_
legbordstelling	legbordstelling	ZNW:EKV:DE_
legbordstellingen	legbordstelling	ZNW:MRV:DE_
retailorganisatie	retailorganisatie	ZNW:EKV:DE_
retailorganisaties	retailorganisatie	ZNW:MRV:DE_
netbeheerkosten	netbeheerkosten	ZNW:MRV:DE_
transporteerbaar	transporteerbaar	BNW:STL:ONV
transporteerbare	transporteerbaar	BNW:STL:VRB
geluidreducerend	geluidreducerend	BNW:STL:ONV
geluidreducerende	geluidreducerend	BNW:STL:VRB
ooggetuigeverslag	ooggetuigeverslag	ZNW:EKV:HET
ooggetuigeverslagen	ooggetuigeverslag	ZNW:MRV:DE_
ooggetuigeverslagje	ooggetuigeverslag	ZNW:EKV:VRK:HET
biosfeerreservaat	biosfeerreservaat	ZNW:EKV:HET
biosfeerreservaten	biosfeerreservaat	ZNW:MRV:DE_
huursombenadering	huursombenadering	ZNW:EKV:DE_
hoorhulpmiddelen	hoorhulpmiddel	ZNW:MRV:DE_
internetbankieromgeving	internetbankieromgeving	ZNW:EKV:DE_
internetbankieromgevingen	internetbankieromgeving	ZNW:MRV:DE_
bouncepercentage	bouncepercentage	ZNW:EKV:HET
bouncepercentages	bouncepercentage	ZNW:MRV:DE_
andersglobalist	andersglobalist	ZNW:EKV:DE_
andersglobalisten	andersglobalist	ZNW:MRV:DE_
segmentboogvormig	segmentboogvormig	BNW:STL:ONV
segmentboogvormige	segmentboogvormig	BNW:STL:VRB
protonpompremmer	protonpompremmer	ZNW:EKV:DE_
protonpompremmers	protonpompremmer	ZNW:MRV:DE_
belastingsaangifte	belastingsaangifte	ZNW:EKV:DE_
belastingsaangiften	belastingsaangifte	ZNW:MRV:DE_
belastingsaangiftes	belastingsaangifte	ZNW:MRV:DE_
quantumfysica	quantumfysica	ZNW:EKV:DE_
mictieklachten	mictieklachten	ZNW:MRV:DE_
tegenpartijrisico	tegenpartijrisico	ZNW:EKV
tegenpartijrisico's	tegenpartijrisico	ZNW:MRV:DE_
reuzenberenklauw	reuzenberenklauw	ZNW:EKV:DE_
reuzenberenklauwen	reuzenberenklauw	ZNW:MRV:DE_
inkomensvervangend	inkomensvervangend	BNW:STL:ONV
inkomensvervangende	inkomensvervangend	BNW:STL:VRB
vergewisplicht	vergewisplicht	ZNW:EKV:DE_
energieslurpend	energieslurpend	BNW:STL:ONV
energieslurpende	energieslurpend	BNW:STL:VRB
keratinebehandeling	keratinebehandeling	ZNW:EKV:DE_
keratinebehandelingen	keratinebehandeling	ZNW:MRV:DE_
linkerooglid	linkerooglid	ZNW:EKV:HET
linkeroogleden	linkerooglid	ZNW:MRV:DE_
immuundeficiëntie	immuundeficiëntie	ZNW:EKV:DE_
immuundeficiënties	immuundeficiëntie	ZNW:MRV:DE_
openbaredienstverplichting	openbaredienstverplichting	ZNW:EKV:DE_
openbaredienstverplichtingen	openbaredienstverplichting	ZNW:MRV:DE_
alumnivereniging	alumnivereniging	ZNW:EKV:DE_
alumniverenigingen	alumnivereniging	ZNW:MRV:DE_
klimaatalarmist	klimaatalarmist	ZNW:EKV:DE_
klimaatalarmisten	klimaatalarmist	ZNW:MRV:DE_
gravitatiegolf	gravitatiegolf	ZNW:EKV:DE_
gravitatiegolven	gravitatiegolf	ZNW:MRV:DE_
toelatinghouder	toelatinghouder	ZNW:EKV:DE_
toelatinghouders	toelatinghouder	ZNW:MRV:DE_
elektronegativiteit	elektronegativiteit	ZNW:EKV:DE_
elektronegativiteiten	elektronegativiteit	ZNW:MRV:DE_
belastingsbetaler	belastingsbetaler	ZNW:EKV:DE_
belastingsbetalers	belastingsbetaler	ZNW:MRV:DE_
compartimentsyndroom	compartimentsyndroom	ZNW:EKV:HET
compartimentsyndromen	compartimentsyndroom	ZNW:MRV:DE_
voedselproducerend	voedselproducerend	BNW:STL:ONV
voedselproducerende	voedselproducerend	BNW:STL:VRB
huurkoopovereenkomst	huurkoopovereenkomst	ZNW:EKV:DE_
huurkoopovereenkomsten	huurkoopovereenkomst	ZNW:MRV:DE_
koolhydraatinname	koolhydraatinname	ZNW:EKV:DE_
financierskapitaal	financierskapitaal	ZNW:EKV:HET
financierskapitalen	financierskapitaal	ZNW:MRV:DE_
rechtervoorpoot	rechtervoorpoot	ZNW:EKV:DE_
rechtervoorpootje	rechtervoorpoot	ZNW:EKV:VRK:HET
rechtervoorpootjes	rechtervoorpoot	ZNW:MRV:VRK:DE_
koolhydraatbeperkt	koolhydraatbeperkt	BNW:STL:ONV
koolhydraatbeperkte	koolhydraatbeperkt	BNW:STL:VRB
belastingssysteem	belastingssysteem	ZNW:EKV:HET
belastingssystemen	belastingssysteem	ZNW:MRV:DE_
richtlijnconform	richtlijnconform	BNW:STL:ONV
richtlijnconforme	richtlijnconform	BNW:STL:VRB
mindfulnesstrainer	mindfulnesstrainer	ZNW:EKV:DE_
mindfulnesstrainers	mindfulnesstrainer	ZNW:MRV:DE_
patronaatsgebouw	patronaatsgebouw	ZNW:EKV:HET
patronaatsgebouwen	patronaatsgebouw	ZNW:MRV:DE_
patronaatsgebouwtje	patronaatsgebouw	ZNW:EKV:VRK:HET
ijzergebreksanemie	ijzergebreksanemie	ZNW:EKV:DE_
ijzergebreksanemieën	ijzergebreksanemie	ZNW:MRV:DE_
ijzergebrekanemie	ijzergebrekanemie	ZNW:EKV:DE_
doorsneesystematiek	doorsneesystematiek	ZNW:EKV:DE_
lactaatacidose	lactaatacidose	ZNW:EKV:DE_
gelaatsbedekkend	gelaatsbedekkend	BNW:STL:ONV
gelaatsbedekkende	gelaatsbedekkend	BNW:STL:VRB
gelaatbedekkend	gelaatbedekkend	BNW:STL:ONV
gelaatbedekkende	gelaatbedekkend	BNW:STL:VRB
voedingsupplement	voedingsupplement	ZNW:EKV:HET
voedingsupplementen	voedingsupplement	ZNW:MRV:DE_
voedingsupplement	voedingsupplement	ZNW:EKV:DE_
kwaliteitsborger	kwaliteitsborger	ZNW:EKV:DE_
kwaliteitsborgers	kwaliteitsborger	ZNW:MRV:DE_
inburgeringcursus	inburgeringcursus	ZNW:EKV:DE_
inburgeringcursussen	inburgeringcursus	ZNW:MRV:DE_
verhalenvertelster	verhalenvertelster	ZNW:EKV:DE_
verhalenvertelsters	verhalenvertelster	ZNW:MRV:DE_
voorkeurdrempel	voorkeurdrempel	ZNW:EKV:DE_
voorkeurdrempels	voorkeurdrempel	ZNW:MRV:DE_
temperatuursstijging	temperatuursstijging	ZNW:EKV:DE_
temperatuursstijgingen	temperatuursstijging	ZNW:MRV:DE_
telomeerlengte	telomeerlengte	ZNW:EKV:DE_
telomeerlengten	telomeerlengte	ZNW:MRV:DE_
telomeerlengtes	telomeerlengte	ZNW:MRV:DE_
dieseltreinstel	dieseltreinstel	ZNW:EKV:HET
dieseltreinstellen	dieseltreinstel	ZNW:MRV:DE_
zondvloedverhaal	zondvloedverhaal	ZNW:EKV:HET
zondvloedverhalen	zondvloedverhaal	ZNW:MRV:DE_
dertigledendebat	dertigledendebat	ZNW:EKV:HET
dertigledendebatten	dertigledendebat	ZNW:MRV:DE_
spellingsvariant	spellingsvariant	ZNW:EKV:DE_
spellingsvarianten	spellingsvariant	ZNW:MRV:DE_
wellnessgedeelte	wellnessgedeelte	ZNW:EKV:HET
bereiksonderzoek	bereiksonderzoek	ZNW:EKV:HET
bereiksonderzoeken	bereiksonderzoek	ZNW:MRV:DE_
spectraalklasse	spectraalklasse	ZNW:EKV:DE_
spectraalklassen	spectraalklasse	ZNW:MRV:DE_
schrob-zuigmachine	schrob-zuigmachine	ZNW:EKV:DE_
schrob-zuigmachines	schrob-zuigmachine	ZNW:MRV:DE_
arbeidshygiënist	arbeidshygiënist	ZNW:EKV:DE_
arbeidshygiënisten	arbeidshygiënist	ZNW:MRV:DE_
naaldsteenvlieg	naaldsteenvlieg	ZNW:EKV:DE_
naaldsteenvliegen	naaldsteenvlieg	ZNW:MRV:DE_
prachtmot	prachtmot	ZNW:EKV:DE_
prachtmotje	prachtmot	ZNW:EKV:VRK:HET
prachtmotten	prachtmot	ZNW:MRV:DE_
bottenaltaar	bottenaltaar	ZNW:EKV:HET
omwindselblad	omwindselblad	ZNW:EKV:HET
omwindselbladen	omwindselblad	ZNW:MRV:DE_
omwindselbladeren	omwindselblad	ZNW:MRV:DE_
omwindselblaadjes	omwindselblad	ZNW:MRV:DE_
gedragsbeïnvloedend	gedragsbeïnvloedend	BNW:STL:ONV
gedragsbeïnvloedende	gedragsbeïnvloedend	BNW:STL:VRB
energieleverend	energieleverend	BNW:STL:ONV
energieleverende	energieleverend	BNW:STL:VRB
levensbeëindigend	levensbeëindigend	BNW:STL:ONV
levensbeëindigende	levensbeëindigend	BNW:STL:VRB
ejectiefractie	ejectiefractie	ZNW:EKV:DE_
ejectiefracties	ejectiefractie	ZNW:MRV:DE_
vastenbiddag	vastenbiddag	ZNW:EKV:DE_
vastenbiddagen	vastenbiddag	ZNW:MRV:DE_
zilverglanzend	zilverglanzend	BNW:STL:ONV
zilverglanzende	zilverglanzend	BNW:STL:VRB
ressortsparket	ressortsparket	ZNW:EKV:HET
ressortsparketten	ressortsparket	ZNW:MRV:DE_
reukofferaltaar	reukofferaltaar	ZNW:EKV
reukofferaltaren	reukofferaltaar	ZNW:MRV:DE_
fiscaalrechtelijk	fiscaalrechtelijk	BNW:STL:ONV
fiscaalrechtelijke	fiscaalrechtelijk	BNW:STL:VRB
halfhoogslaper	halfhoogslaper	ZNW:EKV:DE_
halfhoogslapers	halfhoogslaper	ZNW:MRV:DE_
huishoudentoeslag	huishoudentoeslag	ZNW:EKV:DE_
levensheiliging	levensheiliging	ZNW:EKV:DE_
schermvullende	schermvullend	BNW:STL:VRB
cumarinederivaat	cumarinederivaat	ZNW:EKV:HET
cumarinederivaten	cumarinederivaat	ZNW:MRV:DE_
installatiewizard	installatiewizard	ZNW:EKV
installatiewizards	installatiewizard	ZNW:MRV:DE_
mediationproces	mediationproces	ZNW:EKV:HET
mediationprocessen	mediationproces	ZNW:MRV:DE_
vuurleidingcentrale	vuurleidingcentrale	ZNW:EKV:DE_
vuurleidingcentrales	vuurleidingcentrale	ZNW:MRV:DE_
schoolkorfbaltoernooi	schoolkorfbaltoernooi	ZNW:EKV:HET
schoolkorfbaltoernooien	schoolkorfbaltoernooi	ZNW:MRV:DE_
gewrichtsuitsteeksel	gewrichtsuitsteeksel	ZNW:EKV:HET
gewrichtsuitsteeksels	gewrichtsuitsteeksel	ZNW:MRV:DE_
medebewindstaak	medebewindstaak	ZNW:EKV:DE_
medebewindstaken	medebewindstaak	ZNW:MRV:DE_
polystyreenschuim	polystyreenschuim	ZNW:EKV:HET
energieopwekkend	energieopwekkend	BNW:STL:ONV
energieopwekkende	energieopwekkend	BNW:STL:VRB
ozonlaagafbrekend	ozonlaagafbrekend	BNW:STL:ONV
ozonlaagafbrekende	ozonlaagafbrekend	BNW:STL:VRB
kentekenparkeren	kentekenparkeren	WKW:INF:ZNW:HET
rechterhandschoen	rechterhandschoen	ZNW:EKV:DE_
rechterhandschoenen	rechterhandschoen	ZNW:MRV:DE_
rechterhandschoentje	rechterhandschoen	ZNW:EKV:VRK:HET
energieverbruikend	energieverbruikend	BNW:STL:ONV
energieverbruikende	energieverbruikend	BNW:STL:VRB
shariawetgeving	shariawetgeving	ZNW:EKV:DE_
elektrohydraulisch	elektrohydraulisch	BNW:STL:ONV
elektrohydraulische	elektrohydraulisch	BNW:STL:VRB
beroepservaringperiode	beroepservaringperiode	ZNW:EKV:DE_
gezelschapsleven	gezelschapsleven	ZNW:EKV:HET
trainingschema	trainingschema	ZNW:EKV:HET
trainingschema's	trainingschema	ZNW:MRV:DE_
trainingschemaatje	trainingschema	ZNW:EKV:VRK:HET
raadsinformatiesysteem	raadsinformatiesysteem	ZNW:EKV:HET
raadsinformatiesystemen	raadsinformatiesysteem	ZNW:MRV:DE_
materiezender	materiezender	ZNW:EKV:DE_
materiezenders	materiezender	ZNW:MRV:DE_
zwaardgevest	zwaardgevest	ZNW:EKV:HET
gevesten	gevest	ZNW:MRV:DE_
zwaardgevesten	zwaardgevest	ZNW:MRV:DE_
urgentverklaring	urgentverklaring	ZNW:EKV:DE_
urgentverklaringen	urgentverklaring	ZNW:MRV:DE_
creatinefosfaat	creatinefosfaat	ZNW:EKV:HET
creatinefosfaten	creatinefosfaat	ZNW:MRV:DE_
belastingsvoordeel	belastingsvoordeel	ZNW:EKV:HET
belastingsvoordelen	belastingsvoordeel	ZNW:MRV:DE_
perceelsregistratie	perceelsregistratie	ZNW:EKV:DE_
perceelsregistraties	perceelsregistratie	ZNW:MRV:DE_
insulineproducerend	insulineproducerend	BNW:STL:ONV
insulineproducerende	insulineproducerend	BNW:STL:VRB
koolstofvoetafdruk	koolstofvoetafdruk	ZNW:EKV:DE_
koolstofvoetafdrukken	koolstofvoetafdruk	ZNW:MRV:DE_
waardegedreven	waardegedreven	BNW:STL:ONV
waardegedreven	waardegedreven	BNW:STL:VRB
machineleesbaar	machineleesbaar	BNW:STL:ONV
machineleesbare	machineleesbaar	BNW:STL:VRB
inlenersbeloning	inlenersbeloning	ZNW:EKV:DE_
ex-profvoetballer	ex-profvoetballer	ZNW:EKV:DE_
ex-profvoetballers	ex-profvoetballer	ZNW:MRV:DE_
tussenbeschikking	tussenbeschikking	ZNW:EKV:DE_
tussenbeschikkingen	tussenbeschikking	ZNW:MRV:DE_
rechterooghoek	rechterooghoek	ZNW:EKV:DE_
auto-immuunreactie	auto-immuunreactie	ZNW:EKV:DE_
auto-immuunreacties	auto-immuunreactie	ZNW:MRV:DE_
warmtegeleidend	warmtegeleidend	BNW:STL:ONV
warmtegeleidende	warmtegeleidend	BNW:STL:VRB
prostaathypertrofie	prostaathypertrofie	ZNW:EKV:DE_
buikpijnklachten	buikpijnklachten	ZNW:MRV:DE_
projectteamlid	projectteamlid	ZNW:EKV:HET
projectteamleden	projectteamlid	ZNW:MRV:DE_
nieuwwaarderegeling	nieuwwaarderegeling	ZNW:EKV:DE_
nieuwwaarderegelingen	nieuwwaarderegeling	ZNW:MRV:DE_
spinnengeslacht	spinnengeslacht	ZNW:EKV:HET
spinnengeslachten	spinnengeslacht	ZNW:MRV:DE_
bladneusvleermuis	bladneusvleermuis	ZNW:EKV:DE_
bladneusvleermuizen	bladneusvleermuis	ZNW:MRV:DE_
cultuurfilosofisch	cultuurfilosofisch	BNW:STL:ONV
cultuurfilosofische	cultuurfilosofisch	BNW:STL:VRB
informatiekundig	informatiekundig	BNW:STL:ONV
informatiekundige	informatiekundig	BNW:STL:VRB
triggerpunt	triggerpunt	ZNW:EKV:HET
triggerpunten	triggerpunt	ZNW:MRV:DE_
polyethyleenglycol	polyethyleenglycol	ZNW:EKV:DE_
polyethyleenglycolen	polyethyleenglycol	ZNW:MRV:DE_
aanzegvergoeding	aanzegvergoeding	ZNW:EKV:DE_
aanzegvergoedingen	aanzegvergoeding	ZNW:MRV:DE_
investituurstrijd	investituurstrijd	ZNW:EKV:DE_
eskadercommandant	eskadercommandant	ZNW:EKV:DE_
eskadercommandanten	eskadercommandant	ZNW:MRV:DE_
citroenverbena	citroenverbena	ZNW:EKV:DE_
duurzaamheidcriterium	duurzaamheidcriterium	ZNW:EKV:HET
duurzaamheidcriteria	duurzaamheidcriterium	ZNW:MRV:DE_
werveluitsteeksel	werveluitsteeksel	ZNW:EKV:HET
werveluitsteeksels	werveluitsteeksel	ZNW:MRV:DE_
samenwerkingverband	samenwerkingverband	ZNW:EKV:HET
samenwerkingverbanden	samenwerkingverband	ZNW:MRV:DE_
trainingsessie	trainingsessie	ZNW:EKV:DE_
trainingsessies	trainingsessie	ZNW:MRV:DE_
kruisboogschutter	kruisboogschutter	ZNW:EKV:DE_
kruisboogschutters	kruisboogschutter	ZNW:MRV:DE_
gesprekpartner	gesprekpartner	ZNW:EKV:DE_
gesprekpartners	gesprekpartner	ZNW:MRV:DE_
schuldigerkenning	schuldigerkenning	ZNW:EKV:DE_
schuldigerkenningen	schuldigerkenning	ZNW:MRV:DE_
eerstehulparts	eerstehulparts	ZNW:EKV:DE_
eerstehulpartsen	eerstehulparts	ZNW:MRV:DE_
rododendronstruik	rododendronstruik	ZNW:EKV:DE_
rododendronstruiken	rododendronstruik	ZNW:MRV:DE_
rododendronstruikjes	rododendronstruik	ZNW:MRV:VRK:DE_
geschutspoort	geschutspoort	ZNW:EKV:DE_
geschutspoorten	geschutspoort	ZNW:MRV:DE_
geschutspoortjes	geschutspoort	ZNW:MRV:VRK:DE_
hackerscollectief	hackerscollectief	ZNW:EKV:HET
hackerscollectieven	hackerscollectief	ZNW:MRV:DE_
klimaatsomstandigheid	klimaatsomstandigheid	ZNW:EKV:DE_
klimaatsomstandigheden	klimaatsomstandigheid	ZNW:MRV:DE_
verzetschrift	verzetschrift	ZNW:EKV:HET
verzetschriften	verzetschrift	ZNW:MRV:DE_
urinezuurgehalte	urinezuurgehalte	ZNW:EKV:HET
urinezuurgehalten	urinezuurgehalte	ZNW:MRV:DE_
urinezuurgehaltes	urinezuurgehalte	ZNW:MRV:DE_
rechterhandpalm	rechterhandpalm	ZNW:EKV:DE_
autopsieruimte	autopsieruimte	ZNW:EKV:DE_
autopsieruimten	autopsieruimte	ZNW:MRV:DE_
autopsieruimtes	autopsieruimte	ZNW:MRV:DE_
lesdeelnemer	lesdeelnemer	ZNW:EKV:DE_
lesdeelnemers	lesdeelnemer	ZNW:MRV:DE_
strijdrumoer	strijdrumoer	ZNW:EKV:HET
cortisolspiegel	cortisolspiegel	ZNW:EKV:DE_
cortisolspiegels	cortisolspiegel	ZNW:MRV:DE_
calciumoxalaat	calciumoxalaat	ZNW:EKV:HET
derdenbescherming	derdenbescherming	ZNW:EKV:DE_
aankleedkussenhoes	aankleedkussenhoes	ZNW:EKV:DE_
aankleedkussenhoezen	aankleedkussenhoes	ZNW:MRV:DE_
wielwebspin	wielwebspin	ZNW:EKV:DE_
wielwebspinnen	wielwebspin	ZNW:MRV:DE_
ranonkelfamilie	ranonkelfamilie	ZNW:EKV:DE_
linkerschouderblad	linkerschouderblad	ZNW:EKV:HET
zaaibedbereiding	zaaibedbereiding	ZNW:EKV:DE_
zaaibedbereidingen	zaaibedbereiding	ZNW:MRV:DE_
middentoonstemming	middentoonstemming	ZNW:EKV:DE_
middentoonstemmingen	middentoonstemming	ZNW:MRV:DE_
tuinvogeltelling	tuinvogeltelling	ZNW:EKV:DE_
tuinvogeltellingen	tuinvogeltelling	ZNW:MRV:DE_
teleportatiesprong	teleportatiesprong	ZNW:EKV:DE_
teleportatiesprongen	teleportatiesprong	ZNW:MRV:DE_
temperatuursdaling	temperatuursdaling	ZNW:EKV:DE_
temperatuursdalingen	temperatuursdaling	ZNW:MRV:DE_
rechterschouderblad	rechterschouderblad	ZNW:EKV:HET
shariarechtbank	shariarechtbank	ZNW:EKV:DE_
shariarechtbanken	shariarechtbank	ZNW:MRV:DE_
balsamicodressing	balsamicodressing	ZNW:EKV:DE_
transformatiekanon	transformatiekanon	ZNW:EKV:HET
transformatiekanonnen	transformatiekanon	ZNW:MRV:DE_
cultuurrelativist	cultuurrelativist	ZNW:EKV:DE_
cultuurrelativisten	cultuurrelativist	ZNW:MRV:DE_
binnenachterbeen	binnenachterbeen	ZNW:EKV:HET
binnenachterbenen	binnenachterbeen	ZNW:MRV:DE_
vlekkenverwijderaar	vlekkenverwijderaar	ZNW:EKV:DE_
endometriumkanker	endometriumkanker	ZNW:EKV:DE_
endometriumkankers	endometriumkanker	ZNW:MRV:DE_
wastafelmengkraan	wastafelmengkraan	ZNW:EKV:DE_
wastafelmengkranen	wastafelmengkraan	ZNW:MRV:DE_
wichelroedelopen	wichelroedelopen	WKW:INF:ZNW:HET
cultuurmarxisme	cultuurmarxisme	ZNW:EKV:HET
coronairlijden	coronairlijden	ZNW:EKV:HET
klimaatsceptisch	klimaatsceptisch	BNW:STL:ONV
klimaatsceptische	klimaatsceptisch	BNW:STL:VRB
sociaalrechtelijk	sociaalrechtelijk	BNW:STL:ONV
sociaalrechtelijke	sociaalrechtelijk	BNW:STL:VRB
klimopranken	klimoprank	ZNW:MRV:DE_
klimoprankje	klimoprank	ZNW:EKV:VRK:HET
klimoprankjes	klimoprank	ZNW:MRV:VRK:DE_
veertiendagenbrief	veertiendagenbrief	ZNW:EKV:DE_
socialeverzekeringswet	socialeverzekeringswet	ZNW:EKV:DE_
socialeverzekeringswetten	socialeverzekeringswet	ZNW:MRV:DE_
quantummechanisch	quantummechanisch	BNW:STL:ONV
quantummechanische	quantummechanisch	BNW:STL:VRB
quantumcomputers	quantumcomputer	ZNW:MRV:DE_
computergegenereerd	computergegenereerd	BNW:STL:ONV
computergegenereerde	computergegenereerd	BNW:STL:VRB
bilirubinegehalte	bilirubinegehalte	ZNW:EKV:HET
digibordsoftware	digibordsoftware	ZNW:EKV:DE_
duivelaanbidder	duivelaanbidder	ZNW:EKV:DE_
duivelaanbidders	duivelaanbidder	ZNW:MRV:DE_
integriteitbeleid	integriteitbeleid	ZNW:EKV:HET
overbedelingsschuld	overbedelingsschuld	ZNW:EKV:DE_
overbedelingsschulden	overbedelingsschuld	ZNW:MRV:DE_
verkeersituatie	verkeersituatie	ZNW:EKV:DE_
verkeersituaties	verkeersituatie	ZNW:MRV:DE_
woonzorgvoorziening	woonzorgvoorziening	ZNW:EKV:DE_
woonzorgvoorzieningen	woonzorgvoorziening	ZNW:MRV:DE_
meisjespensionaat	meisjespensionaat	ZNW:EKV:HET
meisjespensionaten	meisjespensionaat	ZNW:MRV:DE_
rolluikenbedrijf	rolluikenbedrijf	ZNW:EKV:HET
rolluikenbedrijven	rolluikenbedrijf	ZNW:MRV:DE_
convectorkachel	convectorkachel	ZNW:EKV:DE_
convectorkachels	convectorkachel	ZNW:MRV:DE_
convectorkacheltje	convectorkachel	ZNW:EKV:VRK:HET
convectorkacheltjes	convectorkachel	ZNW:MRV:VRK:DE_
andersglobalistisch	andersglobalistisch	BNW:STL:ONV
andersglobalistische	andersglobalistisch	BNW:STL:VRB
glutenbevattend	glutenbevattend	BNW:STL:ONV
glutenbevattende	glutenbevattend	BNW:STL:VRB
bevestigingse-mail	bevestigingse-mail	ZNW:EKV:DE_
bevestigingse-mails	bevestigingse-mail	ZNW:MRV:DE_
wereldatletiekfinale	wereldatletiekfinale	ZNW:EKV:DE_
wereldatletiekfinales	wereldatletiekfinale	ZNW:MRV:DE_
konijnentand	konijnentand	ZNW:EKV:DE_
konijnentanden	konijnentand	ZNW:MRV:DE_
konijnentandjes	konijnentand	ZNW:MRV:VRK:DE_
recruitmentbureau	recruitmentbureau	ZNW:EKV:HET
recruitmentbureaus	recruitmentbureau	ZNW:MRV:DE_
reuzenbalsemien	reuzenbalsemien	ZNW:EKV:DE_
reuzenbalsemienen	reuzenbalsemien	ZNW:MRV:DE_
gelijkdenkende	gelijkdenkende	ZNW:EKV:DE_
gelijkdenkenden	gelijkdenkende	ZNW:MRV:DE_
ruimteakoestiek	ruimteakoestiek	ZNW:EKV:DE_
kostengeoriënteerd	kostengeoriënteerd	BNW:STL:ONV
kostengeoriënteerde	kostengeoriënteerd	BNW:STL:VRB
derdengeldenrekening	derdengeldenrekening	ZNW:EKV:DE_
derdengeldenrekeningen	derdengeldenrekening	ZNW:MRV:DE_
moeraswolfsklauw	moeraswolfsklauw	ZNW:EKV:DE_
moeraswolfsklauwen	moeraswolfsklauw	ZNW:MRV:DE_
muilezeldrijver	muilezeldrijver	ZNW:EKV:DE_
muilezeldrijvers	muilezeldrijver	ZNW:MRV:DE_
melkrundveehouderij	melkrundveehouderij	ZNW:EKV:DE_
melkrundveehouderijen	melkrundveehouderij	ZNW:MRV:DE_
structuurtaster	structuurtaster	ZNW:EKV:DE_
structuurtasters	structuurtaster	ZNW:MRV:DE_
afvuurmechanisme	afvuurmechanisme	ZNW:EKV:HET
afvuurmechanismen	afvuurmechanisme	ZNW:MRV:DE_
arbeidsongevallenwet	arbeidsongevallenwet	ZNW:EKV:DE_
arbeidsongevallenwetten	arbeidsongevallenwet	ZNW:MRV:DE_
hielprikscreening	hielprikscreening	ZNW:EKV:DE_
arbeidsmediation	arbeidsmediation	ZNW:EKV:DE_
e-dienstverlening	e-dienstverlening	ZNW:EKV:DE_
contractsoverneming	contractsoverneming	ZNW:EKV:DE_
houtnerfstructuur	houtnerfstructuur	ZNW:EKV:DE_
houtnerfstructuren	houtnerfstructuur	ZNW:MRV:DE_
perceelsoppervlakte	perceelsoppervlakte	ZNW:EKV:DE_
perceelsoppervlakten	perceelsoppervlakte	ZNW:MRV:DE_
perceelsoppervlaktes	perceelsoppervlakte	ZNW:MRV:DE_
staatsnationalisme	staatsnationalisme	ZNW:EKV:HET
verkeerstroom	verkeerstroom	ZNW:EKV:DE_
verkeerstromen	verkeerstroom	ZNW:MRV:DE_
verzetstrijder	verzetstrijder	ZNW:EKV:DE_
verzetstrijders	verzetstrijder	ZNW:MRV:DE_
trackingsysteem	trackingsysteem	ZNW:EKV:HET
trackingsystemen	trackingsysteem	ZNW:MRV:DE_
polycarbonaatplaat	polycarbonaatplaat	ZNW:EKV:DE_
polycarbonaatplaten	polycarbonaatplaat	ZNW:MRV:DE_
lambdacalculus	lambdacalculus	ZNW:EKV:DE_
mainportfunctie	mainportfunctie	ZNW:EKV:DE_
mainportfuncties	mainportfunctie	ZNW:MRV:DE_
benedenvenster	benedenvenster	ZNW:EKV:HET
benedenvensters	benedenvenster	ZNW:MRV:DE_
benedenvenstertjes	benedenvenster	ZNW:MRV:VRK:DE_
klimaatswijziging	klimaatswijziging	ZNW:EKV:DE_
klimaatswijzigingen	klimaatswijziging	ZNW:MRV:DE_
camperverzekering	camperverzekering	ZNW:EKV:DE_
camperverzekeringen	camperverzekering	ZNW:MRV:DE_
belastingstarief	belastingstarief	ZNW:EKV:HET
belastingstarieven	belastingstarief	ZNW:MRV:DE_
achterafweg	achterafweg	ZNW:EKV:DE_
achterafwegen	achterafweg	ZNW:MRV:DE_
achterafweggetje	achterafweg	ZNW:EKV:VRK:HET
achterafweggetjes	achterafweg	ZNW:MRV:VRK:DE_
defecatiepatroon	defecatiepatroon	ZNW:EKV:HET
gegevensbladweergave	gegevensbladweergave	ZNW:EKV:DE_
centrifugaalkracht	centrifugaalkracht	ZNW:EKV:DE_
centrifugaalkrachten	centrifugaalkracht	ZNW:MRV:DE_
tussenrijtuig	tussenrijtuig	ZNW:EKV:HET
tussenrijtuigen	tussenrijtuig	ZNW:MRV:DE_
tussenrijtuigje	tussenrijtuig	ZNW:EKV:VRK:HET
koploperspositie	koploperspositie	ZNW:EKV:DE_
koplopersposities	koploperspositie	ZNW:MRV:DE_
schouderluxatie	schouderluxatie	ZNW:EKV:DE_
schouderluxaties	schouderluxatie	ZNW:MRV:DE_
ruimtekolonist	ruimtekolonist	ZNW:EKV:DE_
ruimtekolonisten	ruimtekolonist	ZNW:MRV:DE_
stroomgebieddistrict	stroomgebieddistrict	ZNW:EKV:HET
stroomgebieddistricten	stroomgebieddistrict	ZNW:MRV:DE_
koolhydraatgehalte	koolhydraatgehalte	ZNW:EKV:HET
koolhydraatgehaltes	koolhydraatgehalte	ZNW:MRV:DE_
postuurkanarie	postuurkanarie	ZNW:EKV:DE_
postuurkanaries	postuurkanarie	ZNW:MRV:DE_
antipestprogramma	antipestprogramma	ZNW:EKV:HET
antipestprogramma's	antipestprogramma	ZNW:MRV:DE_
vruchtboomkanker	vruchtboomkanker	ZNW:EKV:DE_
vruchtboomkankers	vruchtboomkanker	ZNW:MRV:DE_
recidiefpercentage	recidiefpercentage	ZNW:EKV:HET
recidiefpercentages	recidiefpercentage	ZNW:MRV:DE_
kankerwerend	kankerwerend	BNW:STL:ONV
kankerwerende	kankerwerend	BNW:STL:VRB
eerstehulpdoos	eerstehulpdoos	ZNW:EKV:DE_
eerstehulpdoosje	eerstehulpdoos	ZNW:EKV:VRK:HET
eerstehulpdozen	eerstehulpdoos	ZNW:MRV:DE_
geothermieproject	geothermieproject	ZNW:EKV:HET
geothermieprojecten	geothermieproject	ZNW:MRV:DE_
muziekdownload	muziekdownload	ZNW:EKV:DE_
muziekdownloads	muziekdownload	ZNW:MRV:DE_
btw-vrijgesteld	btw-vrijgesteld	BNW:STL:ONV
btw-vrijgestelde	btw-vrijgesteld	BNW:STL:VRB
recruitmentsysteem	recruitmentsysteem	ZNW:EKV:HET
recruitmentsystemen	recruitmentsysteem	ZNW:MRV:DE_
toezichtsfunctie	toezichtsfunctie	ZNW:EKV:DE_
toezichtsfuncties	toezichtsfunctie	ZNW:MRV:DE_
staandwantvisser	staandwantvisser	ZNW:EKV:DE_
staandwantvissers	staandwantvisser	ZNW:MRV:DE_
meekoppelkans	meekoppelkans	ZNW:EKV:DE_
meekoppelkansen	meekoppelkans	ZNW:MRV:DE_
mahoniekleurig	mahoniekleurig	BNW:STL:MRV:DE_
mahoniekleurige	mahoniekleurig	BNW:STL:VRB
straatbanden	straatband	ZNW:MRV:DE_
bedrijfslevenbeleid	bedrijfslevenbeleid	ZNW:EKV:HET
wortelknobbelaal	wortelknobbelaal	ZNW:EKV:DE_
wortelknobbelaaltje	wortelknobbelaal	ZNW:EKV:VRK:HET
wortelknobbelaaltjes	wortelknobbelaal	ZNW:MRV:VRK:DE_
oorlogzuchtig	oorlogzuchtig	BNW:STL:ONV
oorlogzuchtige	oorlogzuchtig	BNW:STL:VRB
copingvaardigheid	copingvaardigheid	ZNW:EKV:DE_
copingvaardigheden	copingvaardigheid	ZNW:MRV:DE_
weerschijnvlinder	weerschijnvlinder	ZNW:EKV:DE_
weerschijnvlinders	weerschijnvlinder	ZNW:MRV:DE_
niet-waarneembaar	niet-waarneembaar	BNW:STL:ONV
niet-waarneembare	niet-waarneembaar	BNW:STL:VRB
wegsleepbedrijf	wegsleepbedrijf	ZNW:EKV:HET
fractuurrisico	fractuurrisico	ZNW:EKV
verzetprocedure	verzetprocedure	ZNW:EKV:DE_
verzetprocedures	verzetprocedure	ZNW:MRV:DE_
maagsapresistent	maagsapresistent	BNW:STL:ONV
maagsapresistente	maagsapresistent	BNW:STL:ONV
vleeskuikenhouderij	vleeskuikenhouderij	ZNW:EKV:DE_
vleeskuikenhouderijen	vleeskuikenhouderij	ZNW:MRV:DE_
hengstenhouderij	hengstenhouderij	ZNW:EKV:DE_
hengstenhouderijen	hengstenhouderij	ZNW:MRV:DE_
rechterooglid	rechterooglid	ZNW:EKV:HET
rechterscheenbeen	rechterscheenbeen	ZNW:EKV:HET
benzineslurpend	benzineslurpend	BNW:STL:ONV
benzineslurpende	benzineslurpend	BNW:STL:VRB
linkerachterpoot	linkerachterpoot	ZNW:EKV:DE_
linkerachterpootje	linkerachterpoot	ZNW:EKV:VRK:HET
deugdenethiek	deugdenethiek	ZNW:EKV:DE_
ziekteresistent	ziekteresistent	BNW:STL:ONV
ziekteresistente	ziekteresistent	BNW:STL:VRB
konijnenhouderij	konijnenhouderij	ZNW:EKV:DE_
konijnenhouderijen	konijnenhouderij	ZNW:MRV:DE_
complexonderdeel	complexonderdeel	ZNW:EKV:HET
complexonderdelen	complexonderdeel	ZNW:MRV:DE_
standwerkersplaats	standwerkersplaats	ZNW:EKV:DE_
standwerkersplaatsen	standwerkersplaats	ZNW:MRV:DE_
krachtsvermindering	krachtsvermindering	ZNW:EKV:DE_
resultaatgedreven	resultaatgedreven	BNW:STL:ONV
resultaatgedreven	resultaatgedreven	BNW:STL:VRB
inzichtmeditatie	inzichtmeditatie	ZNW:EKV:DE_
inzichtmeditaties	inzichtmeditatie	ZNW:MRV:DE_
subsidieslurper	subsidieslurper	ZNW:EKV:DE_
subsidieslurpers	subsidieslurper	ZNW:MRV:DE_
subsidieslurpertje	subsidieslurper	ZNW:EKV:VRK:HET
hofkapelmeester	hofkapelmeester	ZNW:EKV:DE_
vrijheidstrijder	vrijheidstrijder	ZNW:EKV:DE_
vrijheidstrijders	vrijheidstrijder	ZNW:MRV:DE_
paniekwanorde	paniekwanorde	ZNW:EKV:DE_
energieopwekker	energieopwekker	ZNW:EKV:DE_
energieopwekkers	energieopwekker	ZNW:MRV:DE_
fusilladeplaats	fusilladeplaats	ZNW:EKV:DE_
fusilladeplaatsen	fusilladeplaats	ZNW:MRV:DE_
optochtcommissie	optochtcommissie	ZNW:EKV:DE_
optochtcommissies	optochtcommissie	ZNW:MRV:DE_
hondendraagtas	hondendraagtas	ZNW:EKV:DE_
hondendraagtassen	hondendraagtas	ZNW:MRV:DE_
nertsenfokverbod	nertsenfokverbod	ZNW:EKV:HET
ontstaansmechanisme	ontstaansmechanisme	ZNW:EKV:HET
ontstaansmechanismen	ontstaansmechanisme	ZNW:MRV:DE_
ontstaansmechanismes	ontstaansmechanisme	ZNW:MRV:DE_
non-foodproduct	non-foodproduct	ZNW:EKV:HET
non-foodproducten	non-foodproduct	ZNW:MRV:DE_
schraalgrasland	schraalgrasland	ZNW:EKV:HET
schraalgraslanden	schraalgrasland	ZNW:MRV:DE_
schraalgraslandjes	schraalgrasland	ZNW:MRV:VRK:DE_
huisartsgeneeskundig	huisartsgeneeskundig	BNW:STL:ONV
huisartsgeneeskundige	huisartsgeneeskundig	BNW:STL:VRB
peoplemanager	peoplemanager	ZNW:EKV:DE_
peoplemanagers	peoplemanager	ZNW:MRV:DE_
besturingsysteem	besturingsysteem	ZNW:EKV:HET
besturingsystemen	besturingsysteem	ZNW:MRV:DE_
leegstandbeheer	leegstandbeheer	ZNW:EKV:HET
haakbusschutter	haakbusschutter	ZNW:EKV:DE_
haakbusschutters	haakbusschutter	ZNW:MRV:DE_
drijfstanglager	drijfstanglager	ZNW:EKV
drijfstanglagers	drijfstanglager	ZNW:MRV:DE_
drijfstanglagertjes	drijfstanglager	ZNW:MRV:VRK:DE_
demonenmeester	demonenmeester	ZNW:EKV:DE_
demonenmeesters	demonenmeester	ZNW:MRV:DE_
natuurbeherend	natuurbeherend	BNW:STL:ONV
natuurbeherende	natuurbeherend	BNW:STL:VRB
beraadtermijn	beraadtermijn	ZNW:EKV:DE_
crisisnoodopvang	crisisnoodopvang	ZNW:EKV:DE_
jaartalanker	jaartalanker	ZNW:EKV:HET
jaartalankers	jaartalanker	ZNW:MRV:DE_
dominomot	dominomot	ZNW:EKV:DE_
dominomotten	dominomot	ZNW:MRV:DE_
kerfslagwaarde	kerfslagwaarde	ZNW:EKV:DE_
kerfslagwaardes	kerfslagwaarde	ZNW:MRV:DE_
kerfslagwaarden	kerfslagwaarde	ZNW:MRV:DE_
toolboxmeeting	toolboxmeeting	ZNW:EKV:DE_
toolboxmeetingen	toolboxmeeting	ZNW:MRV:DE_
toolboxmeetings	toolboxmeeting	ZNW:MRV:DE_
mainportontwikkeling	mainportontwikkeling	ZNW:EKV:DE_
kleurentouchscreen	kleurentouchscreen	ZNW:EKV:DE_
kleurentouchscreens	kleurentouchscreen	ZNW:MRV:DE_
bedrijfsvertrouwelijk	bedrijfsvertrouwelijk	BNW:STL:ONV
bedrijfsvertrouwelijke	bedrijfsvertrouwelijk	BNW:STL:VRB
suikerspinmachine	suikerspinmachine	ZNW:EKV:DE_
suikerspinmachines	suikerspinmachine	ZNW:MRV:DE_
parallelreuzenslalom	parallelreuzenslalom	ZNW:EKV:DE_
adoptiefmoeder	adoptiefmoeder	ZNW:EKV:DE_
adoptiefmoeders	adoptiefmoeder	ZNW:MRV:DE_
familiegrafkelder	familiegrafkelder	ZNW:EKV:DE_
familiegrafkelders	familiegrafkelder	ZNW:MRV:DE_
fijnstofconcentratie	fijnstofconcentratie	ZNW:EKV:DE_
fijnstofconcentraties	fijnstofconcentratie	ZNW:MRV:DE_
tellerfraude	tellerfraude	ZNW:EKV:DE_
premiumsegment	premiumsegment	ZNW:EKV:HET
premiumsegmenten	premiumsegment	ZNW:MRV:DE_
voorwerpsafstand	voorwerpsafstand	ZNW:EKV:DE_
voorwerpsafstanden	voorwerpsafstand	ZNW:MRV:DE_
derdengeldrekening	derdengeldrekening	ZNW:EKV:DE_
derdengeldrekeningen	derdengeldrekening	ZNW:MRV:DE_
ex-kindsoldaat	ex-kindsoldaat	ZNW:EKV:DE_
ex-kindsoldaatje	ex-kindsoldaat	ZNW:EKV:VRK:HET
ex-kindsoldaatjes	ex-kindsoldaat	ZNW:MRV:VRK:DE_
ex-kindsoldaten	ex-kindsoldaat	ZNW:MRV:DE_
toezichtsbevoegdheid	toezichtsbevoegdheid	ZNW:EKV:DE_
toezichtsbevoegdheden	toezichtsbevoegdheid	ZNW:MRV:DE_
krachtenveldanalyse	krachtenveldanalyse	ZNW:EKV:DE_
krachtenveldanalyses	krachtenveldanalyse	ZNW:MRV:DE_
kruidenstempelmassage	kruidenstempelmassage	ZNW:EKV:DE_
kruidenstempelmassages	kruidenstempelmassage	ZNW:MRV:DE_
sneeuwscootersafari	sneeuwscootersafari	ZNW:EKV:DE_
sneeuwscootersafari's	sneeuwscootersafari	ZNW:MRV:DE_
achterafsteeg	achterafsteeg	ZNW:EKV:DE_
achterafsteegje	achterafsteeg	ZNW:EKV:VRK:HET
achterafsteegjes	achterafsteeg	ZNW:MRV:VRK:DE_
achterafstegen	achterafsteeg	ZNW:MRV:DE_
wereldverzaking	wereldverzaking	ZNW:EKV:DE_
administratorrecht	administratorrecht	ZNW:EKV:HET
administratorrechten	administratorrecht	ZNW:MRV:DE_
aronskelkfamilie	aronskelkfamilie	ZNW:EKV:DE_
bijmengverplichting	bijmengverplichting	ZNW:EKV:DE_
bijmengverplichtingen	bijmengverplichting	ZNW:MRV:DE_
ionisatiekanon	ionisatiekanon	ZNW:EKV:HET
ionisatiekanonnen	ionisatiekanon	ZNW:MRV:DE_
audiëntievertrek	audiëntievertrek	ZNW:EKV:HET
audiëntievertrekken	audiëntievertrek	ZNW:MRV:DE_
cassatieberoepschrift	cassatieberoepschrift	ZNW:EKV:HET
cassatieberoepschriften	cassatieberoepschrift	ZNW:MRV:DE_
tweeënhalfduizend	tweeënhalfduizend	GET:MRV
actinefilament	actinefilament	ZNW:EKV:HET
actinefilamenten	actinefilament	ZNW:MRV:DE_
syndroomschaal	syndroomschaal	ZNW:EKV:DE_
syndroomschalen	syndroomschaal	ZNW:MRV:DE_
spraakapraxie	spraakapraxie	ZNW:EKV:DE_
haalbaarheidstudie	haalbaarheidstudie	ZNW:EKV:DE_
haalbaarheidstudies	haalbaarheidstudie	ZNW:MRV:DE_
securitybedrijf	securitybedrijf	ZNW:EKV:HET
securitybedrijven	securitybedrijf	ZNW:MRV:DE_
therapieontrouw	therapieontrouw	ZNW:EKV:DE_
bedrijfsjuridisch	bedrijfsjuridisch	BNW:STL:ONV
bedrijfsjuridische	bedrijfsjuridisch	BNW:STL:VRB
zuurstofdoorlatend	zuurstofdoorlatend	BNW:STL:ONV
zuurstofdoorlatende	zuurstofdoorlatend	BNW:STL:VRB
payrollwerknemer	payrollwerknemer	ZNW:EKV:DE_
payrollwerknemers	payrollwerknemer	ZNW:MRV:DE_
servervirtualisatie	servervirtualisatie	ZNW:EKV:DE_
belastingsstelsel	belastingsstelsel	ZNW:EKV:HET
belastingsstelsels	belastingsstelsel	ZNW:MRV:DE_
profielschetser	profielschetser	ZNW:EKV:DE_
profielschetsers	profielschetser	ZNW:MRV:DE_
nummerportering	nummerportering	ZNW:EKV:DE_
nummerporteringen	nummerportering	ZNW:MRV:DE_
paardentand	paardentand	ZNW:EKV:DE_
paardentanden	paardentand	ZNW:MRV:DE_
plasmaklaring	plasmaklaring	ZNW:EKV:DE_
voorstadstrein	voorstadstrein	ZNW:EKV:DE_
voorstadstreinen	voorstadstrein	ZNW:MRV:DE_
mascarponemengsel	mascarponemengsel	ZNW:EKV:HET
ontwikkelaarsversie	ontwikkelaarsversie	ZNW:EKV:DE_
ontwikkelaarsversies	ontwikkelaarsversie	ZNW:MRV:DE_
volbloedpaard	volbloedpaard	ZNW:EKV:HET
volbloedpaarden	volbloedpaard	ZNW:MRV:DE_
volbloedpaardjes	volbloedpaard	ZNW:MRV:VRK:DE_
kleiduifschieten	kleiduifschieten	WKW:INF:ZNW:HET
webanalysedienst	webanalysedienst	ZNW:EKV:DE_
webanalysediensten	webanalysedienst	ZNW:MRV:DE_
schoolwelbevinden	schoolwelbevinden	ZNW:EKV:HET
toezichtsarrangement	toezichtsarrangement	ZNW:EKV:HET
toezichtsarrangementen	toezichtsarrangement	ZNW:MRV:DE_
schootsbereik	schootsbereik	ZNW:EKV:HET
trackingcookie	trackingcookie	ZNW:EKV
trackingcookies	trackingcookie	ZNW:MRV:DE_
klinkerteken	klinkerteken	ZNW:EKV:HET
klinkertekens	klinkerteken	ZNW:MRV:DE_
voorstadslijn	voorstadslijn	ZNW:EKV:DE_
voorstadslijnen	voorstadslijn	ZNW:MRV:DE_
serotonineheropnameremmer	serotonineheropnameremmer	ZNW:EKV:DE_
serotonineheropnameremmers	serotonineheropnameremmer	ZNW:MRV:DE_
rijbaanscheiding	rijbaanscheiding	ZNW:EKV:DE_
rijbaanscheidingen	rijbaanscheiding	ZNW:MRV:DE_
cortisolproductie	cortisolproductie	ZNW:EKV:DE_
glazenwassersbedrijf	glazenwassersbedrijf	ZNW:EKV:HET
glazenwassersbedrijfje	glazenwassersbedrijf	ZNW:EKV:VRK:HET
glazenwassersbedrijven	glazenwassersbedrijf	ZNW:MRV:DE_
rechterachterpoot	rechterachterpoot	ZNW:EKV:DE_
rechterachterpootje	rechterachterpoot	ZNW:EKV:VRK:HET
rechterachterpootjes	rechterachterpoot	ZNW:MRV:VRK:DE_
rechterachterpoten	rechterachterpoot	ZNW:MRV:DE_
rechterspiegel	rechterspiegel	ZNW:EKV:DE_
rechterspiegels	rechterspiegel	ZNW:MRV:DE_
pensioensleeftijd	pensioensleeftijd	ZNW:EKV:DE_
pensioensleeftijden	pensioensleeftijd	ZNW:MRV:DE_
webhostingdienst	webhostingdienst	ZNW:EKV:DE_
webhostingdiensten	webhostingdienst	ZNW:MRV:DE_
magnesiumcitraat	magnesiumcitraat	ZNW:EKV
psychofarmacagebruik	psychofarmacagebruik	ZNW:EKV:HET
rendierhouderij	rendierhouderij	ZNW:EKV:DE_
rendierhouderijen	rendierhouderij	ZNW:MRV:DE_
vermogensrendementheffing	vermogensrendementheffing	ZNW:EKV:DE_
hartslagvariabiliteit	hartslagvariabiliteit	ZNW:EKV:DE_
verkoopsargument	verkoopsargument	ZNW:EKV:HET
verkoopsargumenten	verkoopsargument	ZNW:MRV:DE_
verkoopsargumentjes	verkoopsargument	ZNW:MRV:VRK:DE_
antihoofdluismiddel	antihoofdluismiddel	ZNW:EKV:HET
antihoofdluismiddelen	antihoofdluismiddel	ZNW:MRV:DE_
schaarhoogwerker	schaarhoogwerker	ZNW:EKV:DE_
schaarhoogwerkers	schaarhoogwerker	ZNW:MRV:DE_
terugkijktermijn	terugkijktermijn	ZNW:EKV:DE_
terugkijktermijnen	terugkijktermijn	ZNW:MRV:DE_
rechterbroekspijp	rechterbroekspijp	ZNW:EKV:DE_
kledingsvoorschrift	kledingsvoorschrift	ZNW:EKV:HET
kledingsvoorschriften	kledingsvoorschrift	ZNW:MRV:DE_
verkoopbinnendienst	verkoopbinnendienst	ZNW:EKV:DE_
verkoopbinnendiensten	verkoopbinnendienst	ZNW:MRV:DE_
terrasstraler	terrasstraler	ZNW:EKV:DE_
terrasstralers	terrasstraler	ZNW:MRV:DE_
verpleegverblijf	verpleegverblijf	ZNW:EKV:HET
rechtsvoorgangster	rechtsvoorgangster	ZNW:EKV:DE_
rechtsvoorgangsters	rechtsvoorgangster	ZNW:MRV:DE_
verhaalsbijdrage	verhaalsbijdrage	ZNW:EKV:DE_
verhaalsbijdragen	verhaalsbijdrage	ZNW:MRV:DE_
Menorca	Menorca	ENM:LOC:EIL
Adyns	Adyns	ENM:PER:LST
overbruggingskandidaat	overbruggingskandidaat	ZNW:EKV:DE_
hyperambitieus	hyperambitieus	BNW:STL:ONV
hyperambitieuze	hyperambitieus	BNW:STL:VRB
videoduo	videoduo	ZNW:EKV
Jaymillio	Jaymillio	ENM:PER:FST
Konecranes	Konecranes	ENM:ORG
COVAX-programma	COVAX-programma	ZNW:EKV:HET
Antwerp-delegatie	Antwerp-delegatie	ZNW:EKV:DE_
Fazanerija	Fazanerija	ENM:OTH
Dobbelaere-Welvaert	Dobbelaere-Welvaert	ENM:PER:LST
Cesenatico	Cesenatico	ENM:LOC:PTS
verzekeringsfilm	verzekeringsfilm	ZNW:EKV:DE_
verzekeringsfilmpje	verzekeringsfilm	ZNW:EKV:VRK:HET
Sarpsborg	Sarpsborg	ENM:LOC:PTS
Soutar	Soutar	ENM:PER:LST
opengrenzenbeleid	opengrenzenbeleid	ZNW:EKV:HET
gezondheidsnoodtoestand	gezondheidsnoodtoestand	ZNW:EKV:DE_
poollokaal	poollokaal	ZNW:EKV:HET
poollokalen	poollokaal	ZNW:MRV:DE_
Tour-overwinning	Tour-overwinning	ZNW:EKV:DE_
Tour-overwinningen	Tour-overwinning	ZNW:MRV:DE_
Kefah	Kefah	ENM:PER:FST
kasteelkant	kasteelkant	ZNW:EKV:DE_
Overcast	Overcast	ENM:PRD
Milgrom	Milgrom	ENM:PER:LST
soles	sole	ZNW:MRV:DE_
Natuurhulpcentrum	Natuurhulpcentrum	ZNW:EKV:HET
bouwlogeprijs	bouwlogeprijs	ZNW:EKV:DE_
Reusser	Reusser	ENM:PER:LST
SBS-hit	SBS-hit	ZNW:EKV:DE_
Yukos	Yukos	ENM:ORG
Liudmila	Liudmila	ENM:PER:FST
Samsonova	Samsonova	ENM:PER:LST
Theodoros	Theodoros	ENM:PER:FST
Lorantos	Lorantos	ENM:PER:LST
Evjen	Evjen	ENM:PER:LST
Foerster	Foerster	ENM:PER:LST
energiebespaarbudget	energiebespaarbudget	ZNW:EKV:HET
ex-PSG-speler	ex-PSG-speler	ZNW:EKV:DE_
Nkunku	Nkunku	ENM:PER:LST
hennaheks	hennaheks	ZNW:EKV:DE_
Haret	Haret	ENM:PER:LST
Delphin	Delphin	ENM:ORG
Pommelien	Pommelien	ENM:PER:FST
Chrysler-gebouw	Chrysler-gebouw	ZNW:EKV:HET
Chryslergebouw	Chryslergebouw	ZNW:EKV:HET
Sapporo	Sapporo	ENM:LOC:PTS
sepiaschelprand	sepiaschelprand	ZNW:EKV:DE_
sepiaschelpranden	sepiaschelprand	ZNW:MRV:DE_
koteigenaar	koteigenaar	ZNW:EKV:DE_
koteigenaars	koteigenaar	ZNW:MRV:DE_
Trésors	Trésor	ENM:BEZ
Tegnérs	Tegnér	ENM:BEZ
Plantagenets	Plantagenet	ENM:BEZ
Vistaprints	Vistaprint	ENM:BEZ
Paramounts	Paramount	ENM:BEZ
Soutars	Soutar	ENM:BEZ
Milgroms	Milgrom	ENM:BEZ
Foersters	Foerster	ENM:BEZ
Delphins	Delphin	ENM:BEZ
tegenbreak	tegenbreak	ZNW:EKV:DE_
tegenbreaks	tegenbreak	ZNW:MRV:DE_
Facebook-vertegenwoordiger	Facebook-vertegenwoordiger	ZNW:EKV:DE_
geurceremonie	geurceremonie	ZNW:EKV:DE_
wierookpot	wierookpot	ZNW:EKV:DE_
wierookpotje	wierookpot	ZNW:EKV:VRK:HET
wierookpotjes	wierookpot	ZNW:MRV:VRK:DE_
wierookpotten	wierookpot	ZNW:MRV:DE_
vpn-aanbieder	vpn-aanbieder	ZNW:EKV:DE_
Troicki	Troicki	ENM:PER:LST
lichtschildermodus	lichtschildermodus	ZNW:EKV:DE_
Zalgiris	Zalgiris	ENM:LOC:PTS
Wena	Wena	ENM:PER:FST
Euroborg	Euroborg	ENM:ORG
Ádám	Ádám	ENM:PER:FST
Xinhua	Xinhua	ENM:ORG
Sophos	Sophos	ENM:ORG
restauratiestichting	restauratiestichting	ZNW:EKV:DE_
vinbreuk	vinbreuk	ZNW:EKV:DE_
vinbreuken	vinbreuk	ZNW:MRV:DE_
coronapositief	coronapositief	BNW:STL:ONV
coronapositieve	coronapositief	BNW:STL:VRB
Wicklow	Wicklow	ENM:LOC:PTS
Swaroop	Swaroop	ENM:PER:FST
Älmsta	Älmsta	ENM:LOC:PTS
Hoogkerk-Zuid	Hoogkerk-Zuid	ENM:LOC:RGN
Orinoco	Orinoco	ZNW:EKV:DE_
Asturias	Asturias	ENM:OTH
Sjöstrom	Sjöstrom	ENM:PER:LST
Röttgen	Röttgen	ENM:PER:LST
OCMW-voorzitster	OCMW-voorzitster	ZNW:EKV:DE_
Ashimeru	Ashimeru	ENM:PER:LST
Netflixdocumentaire	Netflixdocumentaire	ZNW:EKV:DE_
glitteroogschaduw	glitteroogschaduw	ZNW:EKV:DE_
Girlguiding	Girlguiding	ENM:ORG
Amstetten	Amstetten	ENM:LOC:RGN
Bosuilstadion	Bosuilstadion	ZNW:EKV:HET
Brulocalis	Brulocalis	ENM:ORG
filmmuziekalbum	filmmuziekalbum	ZNW:EKV:HET
drugtrafikant	drugtrafikant	ZNW:EKV:DE_
drugtrafikanten	drugtrafikant	ZNW:MRV:DE_
drugstrafikant	drugstrafikant	ZNW:EKV:DE_
drugstrafikanten	drugstrafikant	ZNW:MRV:DE_
Talbut	Talbut	ENM:PER:LST
L’Equipe	L’Equipe	ENM:ORG
L'Equipe	L'Equipe	ENM:ORG
NFL-seizoen	NFL-seizoen	ZNW:EKV:HET
downloadbug	downloadbug	ZNW:EKV:DE_
Röttgens	Röttgen	ENM:BEZ
Talbuts	Talbut	ENM:BEZ
Panos	Panos	ENM:PER:FST
Lütfi	Lütfi	ENM:PER:FST
Gviniashvili	Gviniashvili	ENM:PER:LST
videobelsysteem	videobelsysteem	ZNW:EKV:HET
antidrugsdienst	antidrugsdienst	ZNW:EKV:DE_
zeildelen	zeildeel	ZNW:MRV:DE_
cocktailterm	cocktailterm	ZNW:EKV:DE_
stormscène	stormscène	ZNW:EKV:DE_
stormscènes	stormscène	ZNW:MRV:DE_
toptornooi	toptornooi	ZNW:EKV:HET
toptornooien	toptornooi	ZNW:MRV:DE_
Brereton	Brereton	ENM:PER:LST
Cahira	Cahira	ENM:PER:FST
G20-land	G20-land	ZNW:EKV:HET
G20-landen	G20-land	ZNW:MRV:DE_
UU-econoom	UU-econoom	ZNW:EKV:DE_
iPhone-fabrikant	iPhone-fabrikant	ZNW:EKV:DE_
iPhone-fabrikanten	iPhone-fabrikant	ZNW:MRV:DE_
iPhonefabrikant	iPhonefabrikant	ZNW:EKV:DE_
houtskoolwerker	houtskoolwerker	ZNW:EKV:DE_
houtskoolwerkers	houtskoolwerker	ZNW:MRV:DE_
persoonsbeschermingseenheid	persoonsbeschermingseenheid	ZNW:EKV:DE_
tartaarmerk	tartaarmerk	ZNW:EKV:HET
Uplace	Uplace	ENM:ORG
Kamerwerk	Kamerwerk	ZNW:EKV:HET
McDonald's-restaurant	McDonald's-restaurant	ZNW:EKV:HET
McDonald's-restaurants	McDonald's-restaurant	ZNW:MRV:DE_
Bissegger	Bissegger	ENM:PER:LST
Dakarnorm	Dakarnorm	ZNW:EKV:DE_
bakingrediënt	bakingrediënt	ZNW:EKV:HET
bakingrediënten	bakingrediënt	ZNW:MRV:DE_
merkenobsessie	merkenobsessie	ZNW:EKV:DE_
C-segment	C-segment	ZNW:EKV:HET
vismarktkraam	vismarktkraam	ZNW:EKV
vissorteerder	vissorteerder	ZNW:EKV:DE_
vissorteerders	vissorteerder	ZNW:MRV:DE_
Rojo	Rojo	ENM:PER:LST
isoleerblok	isoleerblok	ZNW:EKV:HET
groentepizzabedrijf	groentepizzabedrijf	ZNW:EKV:HET
Magioni	Magioni	ENM:ORG
touchdown	touchdown	ZNW:EKV:DE_
touchdowns	touchdown	ZNW:MRV:DE_
Fellini	Fellini	ENM:PER:LST
Osbournes	Osbournes	ZNW:MRV:DE_
Maraj	Maraj	ENM:PER:LST
Mahathir	Mahathir	ENM:PER:LST
Spirou	Spirou	ENM:OTH
Levante-verdediger	Levante-verdediger	ZNW:EKV:DE_
Trump-kringen	Trump-kringen	ZNW:MRV:DE_
D'Onofrio	D'Onofrio	ENM:PER:LST
Norwegian	Norwegian	ENM:OTH
langdurigezorgontvanger	langdurigezorgontvanger	ZNW:EKV:DE_
Lacote	Lacote	ENM:PER:LST
MacKay-clan	MacKay-clan	ZNW:EKV:DE_
Jan-Emmanuel	Jan-Emmanuel	ENM:PER:FST
coronataks	coronataks	ZNW:EKV:DE_
stoplichtsprint	stoplichtsprint	ZNW:EKV:DE_
stoplichtsprintje	stoplichtsprint	ZNW:EKV:VRK:HET
stoplichtsprintjes	stoplichtsprint	ZNW:MRV:VRK:DE_
stoplichtsprints	stoplichtsprint	ZNW:MRV:DE_
Rotenberg	Rotenberg	ENM:PER:LST
militielied	militielied	ZNW:EKV:HET
bezoekersmaatregel	bezoekersmaatregel	ZNW:EKV:DE_
bezoekersmaatregelen	bezoekersmaatregel	ZNW:MRV:DE_
NBA-kampioen	NBA-kampioen	ZNW:EKV:DE_
NBA-kampioenen	NBA-kampioen	ZNW:MRV:DE_
Twirlbound	Twirlbound	ENM:ORG
Edge-browser	Edge-browser	ZNW:EKV:DE_
Breretons	Brereton	ENM:BEZ
Mahathirs	Mahathir	ENM:BEZ
Rotenbergs	Rotenberg	ENM:BEZ
Rachmon	Rachmon	ENM:PER:LST
Altmaier	Altmaier	ENM:PER:LST
YouTube-serie	YouTube-serie	ZNW:EKV:DE_
YouTube-series	YouTube-serie	ZNW:MRV:DE_
berenopvang	berenopvang	ZNW:EKV:DE_
slachtoffercel	slachtoffercel	ZNW:EKV:DE_
walvissenlijk	walvissenlijk	ZNW:EKV:HET
Cedris	Cedris	ENM:ORG
infectieonderzoeker	infectieonderzoeker	ZNW:EKV:DE_
levensuniversum	levensuniversum	ZNW:EKV:HET
visbioloog	visbioloog	ZNW:EKV:DE_
visbiologen	visbioloog	ZNW:MRV:DE_
kutbrief	kutbrief	ZNW:EKV:DE_
kutbriefje	kutbrief	ZNW:EKV:VRK:HET
Yamamoto	Yamamoto	ENM:PER:FST
ruitjespak	ruitjespak	ZNW:EKV:HET
ruitjespakken	ruitjespak	ZNW:MRV:DE_
massastranding	massastranding	ZNW:EKV:DE_
Verzilov	Verzilov	ENM:PER:LST
ochtendkoelte	ochtendkoelte	ZNW:EKV:DE_
meisjesverblijf	meisjesverblijf	ZNW:EKV:HET
melkgeitenhouderij	melkgeitenhouderij	ZNW:EKV:DE_
melkgeitenhouderijen	melkgeitenhouderij	ZNW:MRV:DE_
cortisolwaarde	cortisolwaarde	ZNW:EKV:DE_
cortisolwaardes	cortisolwaarde	ZNW:MRV:DE_
cortisolwaarden	cortisolwaarde	ZNW:MRV:DE_
pneumokokkenvaccin	pneumokokkenvaccin	ZNW:EKV:HET
pneumokokkenvaccins	pneumokokkenvaccin	ZNW:MRV:DE_
gereedschapmakerij	gereedschapmakerij	ZNW:EKV:DE_
gereedschapmakerijen	gereedschapmakerij	ZNW:MRV:DE_
tussenvoorraad	tussenvoorraad	ZNW:EKV:DE_
tussenvoorraden	tussenvoorraad	ZNW:MRV:DE_
doctoraatsbursaal	doctoraatsbursaal	ZNW:EKV:DE_
doctoraatsbursalen	doctoraatsbursaal	ZNW:MRV:DE_
kattenverjager	kattenverjager	ZNW:EKV:DE_
non-hodgkinlymfoom	non-hodgkinlymfoom	ZNW:EKV
non-hodgkinlymfomen	non-hodgkinlymfoom	ZNW:MRV:DE_
greppeldwerg	greppeldwerg	ZNW:EKV:DE_
greppeldwergen	greppeldwerg	ZNW:MRV:DE_
zelfdeterminatietheorie	zelfdeterminatietheorie	ZNW:EKV:DE_
covid-19-testset	covid-19-testset	ZNW:EKV:DE_
Dunbar	Dunbar	ENM:PER:LST
Pasjinjan	Pasjinjan	ENM:PER:LST
L'Echo	L'Echo	ENM:ORG
Karaj	Karaj	ENM:LOC:PTS
Garray	Garray	ENM:LOC:PTS
Garray	Garray	ENM:PER:LST
Naypyitaw	Naypyitaw	ENM:LOC:PTS
Ontanon	Ontanon	ENM:PER:LST
Imanuelle	Imanuelle	ENM:PER:FST
bananenvoorzet	bananenvoorzet	ZNW:EKV:DE_
bananenvoorzetten	bananenvoorzet	ZNW:MRV:DE_
derdendeel	derdendeel	ZNW:EKV:HET
derdendelen	derdendeel	ZNW:MRV:DE_
Ajax-ploeggenoot	Ajax-ploeggenoot	ZNW:EKV:DE_
Ajax-ploeggenoten	Ajax-ploeggenoot	ZNW:MRV:DE_
NBA-sterspeler	NBA-sterspeler	ZNW:EKV:DE_
NBA-sterspelers	NBA-sterspeler	ZNW:MRV:DE_
Movistar-renner	Movistar-renner	ZNW:EKV:DE_
Movistar-renners	Movistar-renner	ZNW:MRV:DE_
Urbicoon	Urbicoon	ENM:ORG
Beeple	Beeple	ENM:ORG
Gnohéré	Gnohéré	ENM:PER:LST
Trainor	Trainor	ENM:PER:LST
Playmobil-huis	Playmobil-huis	ZNW:EKV:HET
Nikon-camera	Nikon-camera	ZNW:EKV:DE_
Nikon-camera's	Nikon-camera	ZNW:MRV:DE_
Nikoncamera	Nikoncamera	ZNW:EKV:DE_
Nikoncamera's	Nikoncamera	ZNW:MRV:DE_
Fietsersbond	Fietsersbond	ZNW:EKV:DE_
peenkleurig	peenkleurig	BNW:STL:ONV
peenkleurige	peenkleurig	BNW:STL:VRB
Dehenauw	Dehenauw	ENM:PER:LST
Dunbars	Dunbar	ENM:BEZ
Trainors	Trainor	ENM:BEZ
CoronaCheck	CoronaCheck	ENM:PRD
Harush	Harush	ENM:PER:LST
eredivisiebasisplaats	eredivisiebasisplaats	ZNW:EKV:DE_
eredivisie-basisplaats	eredivisie-basisplaats	ZNW:EKV:DE_
Martellotoren	Martellotoren	ZNW:EKV:DE_
Nzérékoré	Nzérékoré	ENM:LOC:RGN
Aduba	Aduba	ENM:PER:LST
Pessina	Pessina	ENM:PER:LST
Acerta	Acerta	ENM:ORG
copresident	copresident	ZNW:EKV:DE_
Piero	Piero	ENM:PER:FST
Atletico	Atletico	ENM:ORG
proftijdperk	proftijdperk	ZNW:EKV:HET
