# deleted postag entries
#-------------------------------------------------------------------------------
# Do not add words here, but report them to languagetool@taaltik.nl
#-------------------------------------------------------------------------------
borger	borger	ZNW:EKV
bovenwater	bovenwater	ZNW:EKV:HET
carcinoompjes	carcinoom	ZNW:MRV:VRK:DE_
commandantjes	commandant	ZNW:MRV:VRK:DE_
competentietjes	competentie	ZNW:MRV:VRK:DE_
dwingendrechtelijke	dwingendrechtelijke	BNW:STL:VRB
fiscaalrechtelijke	fiscaalrechtelijke	BNW:STL:VRB
houderij	houderij	ZNW:EKV
luxatie	luxatie	ZNW:EKV
onderwater	onderwater	ZNW:EKV:HET
onderwatertjes	onderwater	ZNW:MRV:VRK:DE_
opwekker	opwekker	ZNW:EKV
podoloog	podoloog	ZNW:EKV
relativist	relativist	ZNW:EKV
schetser	schetser	ZNW:EKV
screening	screening	ZNW:EKV
slurper	slurper	ZNW:EKV
straler	straler	ZNW:EKV
werkplaat	werkplaat	ZNW:EKV:DE_
werkplaatje	werkplaat	ZNW:EKV:VRK:HET
werkplaatjes	werkplaat	ZNW:MRV:VRK:DE_
werkplaten	werkplaat	ZNW:MRV:DE_
corticosteroïde	corticosteroïde	ZNW:EKV
levensbeëindigende	levensbeëindigende	BNW:STL:VRB
lands	lands	DVW
ziele	ziele	DVW
peenkleurige	peenkleurige	BNW:STL:VRB
bovenwateren	bovenwater	ZNW:MRV:DE_
onderwateren	onderwater	ZNW:MRV:DE_
onderwaters	onderwater	ZNW:MRV:DE_
kencijfertjes	kencijfer	ZNW:MRV:VRK:DE_
L’Equipe	L’Equipe	ENM:PRD
